{
  "name": "Iris Rev. 6",
  "vendorProductId": 3406848598,
  "macros": ["", "", "", "", "", "", "", "", "", "", "", "", "", "", "", ""],
  "layers": [
    [
      "KC_ESC",
      "KC_1",
      "KC_2",
      "KC_3",
      "KC_4",
      "KC_5",
      "KC_TAB",
      "KC_Q",
      "KC_W",
      "KC_F",
      "KC_P",
      "KC_G",
      "KC_BSPC",
      "KC_A",
      "KC_R",
      "KC_S",
      "KC_T",
      "KC_D",
      "MT(MOD_LSFT,KC_CAPS)",
      "KC_Z",
      "KC_X",
      "KC_C",
      "KC_V",
      "KC_B",
      "KC_NO",
      "KC_NO",
      "FN_MO23",
      "FN_MO13",
      "KC_LGUI",
      "KC_MPRV",
      "KC_BSPC",
      "KC_0",
      "KC_9",
      "KC_8",
      "KC_7",
      "KC_6",
      "KC_BSLS",
      "KC_SCLN",
      "KC_Y",
      "KC_U",
      "KC_L",
      "KC_J",
      "KC_QUOT",
      "KC_O",
      "KC_I",
      "KC_E",
      "KC_N",
      "KC_H",
      "MT(MOD_LSFT | MOD_RSFT,KC_ENT)",
      "KC_SLSH",
      "KC_DOT",
      "KC_COMM",
      "KC_M",
      "KC_K",
      "KC_NO",
      "KC_NO",
      "FN_MO13",
      "KC_SPC",
      "KC_ENT",
      "KC_MNXT"
    ],
    [
      "KC_GRV",
      "KC_EXLM",
      "KC_AT",
      "KC_HASH",
      "KC_DLR",
      "KC_PERC",
      "RESET",
      "KC_TRNS",
      "KC_TRNS",
      "KC_UP",
      "KC_MINS",
      "KC_UNDS",
      "KC_DEL",
      "KC_TRNS",
      "KC_LEFT",
      "KC_DOWN",
      "KC_RGHT",
      "KC_EQL",
      "BL_STEP",
      "KC_TRNS",
      "KC_TRNS",
      "KC_TRNS",
      "KC_LPRN",
      "KC_RPRN",
      "KC_NO",
      "KC_NO",
      "KC_TRNS",
      "KC_TRNS",
      "KC_DEL",
      "KC_TRNS",
      "KC_BSPC",
      "KC_EQL",
      "KC_MINS",
      "KC_ASTR",
      "KC_AMPR",
      "KC_CIRC",
      "KC_TRNS",
      "KC_TRNS",
      "KC_TRNS",
      "KC_TRNS",
      "KC_TRNS",
      "KC_TRNS",
      "KC_PIPE",
      "KC_PLUS",
      "KC_TRNS",
      "KC_TRNS",
      "KC_RBRC",
      "KC_LBRC",
      "KC_TRNS",
      "KC_TRNS",
      "KC_TRNS",
      "KC_TRNS",
      "KC_RCBR",
      "KC_LCBR",
      "KC_NO",
      "KC_NO",
      "KC_TRNS",
      "KC_TRNS",
      "KC_DEL",
      "KC_TRNS"
    ],
    [
      "KC_F12",
      "KC_F1",
      "KC_F2",
      "KC_F3",
      "KC_F4",
      "KC_F5",
      "RGB_TOG",
      "KC_EXLM",
      "KC_AT",
      "KC_HASH",
      "KC_DLR",
      "KC_PERC",
      "RGB_MOD",
      "KC_MPRV",
      "KC_MNXT",
      "KC_VOLU",
      "KC_PGUP",
      "KC_UNDS",
      "KC_MUTE",
      "KC_MSTP",
      "KC_MPLY",
      "KC_VOLD",
      "KC_PGDN",
      "KC_MINS",
      "KC_NO",
      "KC_NO",
      "KC_TRNS",
      "KC_TRNS",
      "KC_TRNS",
      "KC_LPRN",
      "KC_F11",
      "KC_F10",
      "KC_F9",
      "KC_F8",
      "KC_F7",
      "KC_F6",
      "KC_TRNS",
      "KC_RPRN",
      "KC_LPRN",
      "KC_ASTR",
      "KC_AMPR",
      "KC_CIRC",
      "KC_BSLS",
      "RGB_VAI",
      "RGB_SAI",
      "RGB_HUI",
      "KC_HOME",
      "KC_EQL",
      "KC_TRNS",
      "RGB_VAD",
      "RGB_SAD",
      "RGB_HUD",
      "KC_END",
      "KC_PLUS",
      "KC_NO",
      "KC_NO",
      "KC_TRNS",
      "KC_TRNS",
      "KC_TRNS",
      "KC_TRNS"
    ],
    [
      "KC_TRNS",
      "KC_TRNS",
      "KC_TRNS",
      "KC_TRNS",
      "KC_TRNS",
      "KC_TRNS",
      "KC_TRNS",
      "KC_TRNS",
      "KC_TRNS",
      "KC_TRNS",
      "KC_TRNS",
      "KC_TRNS",
      "KC_TRNS",
      "KC_TRNS",
      "KC_TRNS",
      "KC_TRNS",
      "KC_TRNS",
      "KC_TRNS",
      "KC_TRNS",
      "KC_TRNS",
      "KC_TRNS",
      "KC_TRNS",
      "KC_TRNS",
      "KC_TRNS",
      "KC_NO",
      "KC_NO",
      "KC_TRNS",
      "KC_TRNS",
      "KC_TRNS",
      "KC_TRNS",
      "KC_TRNS",
      "KC_TRNS",
      "KC_TRNS",
      "KC_TRNS",
      "KC_TRNS",
      "KC_TRNS",
      "KC_TRNS",
      "KC_TRNS",
      "KC_TRNS",
      "KC_TRNS",
      "KC_TRNS",
      "KC_TRNS",
      "KC_TRNS",
      "KC_TRNS",
      "KC_TRNS",
      "KC_TRNS",
      "KC_TRNS",
      "KC_TRNS",
      "KC_TRNS",
      "KC_TRNS",
      "KC_TRNS",
      "KC_TRNS",
      "KC_TRNS",
      "KC_TRNS",
      "KC_NO",
      "KC_NO",
      "KC_TRNS",
      "KC_TRNS",
      "KC_TRNS",
      "KC_TRNS"
    ]
  ]
}